You are part of an organization known as the CIA. Your boss has given you a task: You need to send a top secret document that will aid the United States in their quarrel against ISIS. Currently, ISIS is attacking the US and they are growing in numbers. This document has blueprints for a technology that will aid in the fight against the terrorists. But more importantly, you need reliable WiFi to send this document. You don't want it to fall into the wrong hands. Find a reliable WiFi connection so you can send the document.

Reliable WiFi
An Interactive Fiction by kstoffer17
Release 1 / Serial number 170227 / Inform 7 build 6M62 (I6/v6.33 lib 6/12N) SD

My Office
A small cubicle, with just enough space to fit a desk and a relatively comfortable chair.

You can see an oak door here.

>east
(first opening the oak door)
It seems to be locked.

>x esk
You can't see any such thing.

>x desk
The desk is a rich, dark brown mahogany with a couple drawers. It is cluttered with a sort of well-organized chaos of files, papers, letters, and god-knows-what-else.

>x drawers
It's a drawer.

>open drawer
You open the drawer, revealing a key.

* * *

>n
Hallway
The long spacious hallway leads to the Elevator. There are a couple pictures posted on the walls.

>e
You can't go that way.

>w
Elevator
A standard elevator. The elevator door creaks as the it slowly closes. Hopefully this will lead you to the 1st floor.

>e
Hallway
The long spacious hallway leads to the Elevator. There are a couple pictures posted on the walls.

>s
My Office
A small cubicle, with just enough space to fit a desk and a relatively comfortable chair.

You can see an oak door here.

>x desk
The desk is a rich, dark brown mahogany with a couple drawers. It is cluttered with a sort of well-organized chaos of files, papers, letters, and god-knows-what-else. There is also your laptop.

>xtake laptop
That's not a verb I recognise.

>take laptop
Taken.

>x desk
The desk is a rich, dark brown mahogany with a couple drawers. It is cluttered with a sort of well-organized chaos of files, papers, letters, and god-knows-what-else. There is also your laptop.

* * *

>n
Hallway
The long spacious hallway leads to the Elevator. There are a couple pictures posted on the walls.

>s
My Office
A small cubicle, with just enough space to fit a desk and a relatively comfortable chair.

You can see an oak door here.

* * *

>x desk
The desk is a rich, dark brown mahogany with a couple drawers. It is cluttered with a sort of well-organized chaos of files, papers, letters, and god-knows-what-else. There is also your laptop.

>take laptop
Taken.

>x drawers
Just an ordinary drawer, but I wonder what's inside.

>open drawer
You open the drawer, revealing a key.

>take key
Taken.

>open door with key
You unlock the oak door.

>s
You can't go that way.

>e
(first opening the oak door)

Boss's Office
His chair seems like it is 10 times more comfortable than yours does. But then again, he is your boss.

You can see an oak door and a flashlight here.

>take flashlight
Taken.

>n
You can't go that way.

>s
You can't go that way.

>w
My Office
A small cubicle, with just enough space to fit a desk and a relatively comfortable chair.

You can see an oak door here.

>n
Hallway
The long spacious hallway leads to the Elevator. There are a couple pictures posted on the walls.

>n
You can't go that way.

>s
My Office
A small cubicle, with just enough space to fit a desk and a relatively comfortable chair.

You can see an oak door here.

>n
Hallway
The long spacious hallway leads to the Elevator. There are a couple pictures posted on the walls.

* * *

>w
Elevator
A standard elevator. The elevator door creaks as the it slowly closes. Hopefully this will lead you to the 1st floor.

>n
Outdoors
The weather could be better, it's a stormy day. The dark clouds cover the sun, and you can sense the rain incoming. You should probably get to some cover.

>n
McDonalds
As you enter the restaurant, the smell of grease fills the air. A whole new world of diabetes and clogged heart arteries is here. Welcome to McDonald's an employee says. There is also free Wifi here.

>x wifi
You can't see any such thing.

>x wifi
You can't see any such thing.

* * *

>n
Hallway
The long spacious hallway leads to the Elevator. There are a couple pictures posted on the walls.

>w
Elevator
A standard elevator. The elevator door creaks as the it slowly closes. Hopefully this will lead you to the 1st floor.

* * *

>n
McDonalds
As you enter the restaurant, the smell of grease fills the air. A whole new world of diabetes and clogged heart arteries is here. Welcome to McDonald's an employee says. There is also free Wifi here.

>x wifi
You open your laptop and turn it on. You go straight to google chrome, and accept the terms and conditions. You paitently wait as the WiFi is busy connecting. Shucks...The WiFi sucks here, it's only one bar. After all, it is McDonald's WiFi. You are going to have to find better WiFi to send the document.

>examine wifi
You open your laptop and turn it on. You go straight to google chrome, and accept the terms and conditions. You paitently wait as the WiFi is busy connecting. Shucks...The WiFi sucks here, it's only one bar. After all, it is McDonald's WiFi. You are going to have to find better WiFi to send the document.

>take wifi
That's hardly portable.

>x wifi
You open your laptop and turn it on. You go straight to google chrome, and accept the terms and conditions. You paitently wait as the WiFi is busy connecting. Shucks...The WiFi sucks here, it's only one bar. After all, it is McDonald's WiFi. You are going to have to find better WiFi to send the document.

>take wifi
That's hardly portable.

>s
Outdoors
The weather could be better, it's a stormy day. The dark clouds cover the sun, and you can sense the rain incoming. You should probably get to some cover.

>s
Elevator
A standard elevator. The elevator door creaks as the it slowly closes. Hopefully this will lead you to the 1st floor.

>n
Outdoors
The weather could be better, it's a stormy day. The dark clouds cover the sun, and you can sense the rain incoming. You should probably get to some cover.

>w
Starbucks
The smell of freshly brewed roasted coffee fills the air. There is a relatively long waiting line, but it's worth it. You don't want to be that one person who uses the wifi without purchasing anything.

>x wifi
You can't see any such thing.

* * *

>ne
You can't go that way.

>n
Hallway
The long spacious hallway leads to the Elevator. There are a couple pictures posted on the walls.

* * *

>e
You can't go that way.

>e
You can't go that way.

* * *

>unlock door
What do you want to unlock the oak door with?

>use key on oak door
You can't see any such thing.

>i
You are carrying nothing.

* * *

>w
Darkness
It is pitch dark, and you can't see a thing.

>e
My Office
A small cubicle, with just enough space to fit a desk and a relatively comfortable chair.

You can see an oak door here.

>x desk
The desk is a rich, dark brown mahogany with a couple drawers. It is cluttered with a sort of well-organized chaos of files, papers, letters, and god-knows-what-else. There is also your laptop.

>x drawer
Just an ordinary drawer, but I wonder what's inside.

>open drawer
You open the drawer, revealing a key.

* * *

>open door with key
You unlock the oak door.

>e
(first opening the oak door)

Boss's Office
His chair seems like it is 10 times more comfortable than yours does. But then again, he is your boss.

You can see an oak door and a flashlight here.

* * *

>take flashlight
Taken.

>w
My Office
A small cubicle, with just enough space to fit a desk and a relatively comfortable chair.

You can see an oak door here.

>w
Darkness
It is pitch dark, and you can't see a thing.

>turn on light
You can't see any such thing.

>turn on flashlight
It's really not that bright. The batteries are probably almost dead. But it's better than nothing and at least it works in dark rooms.

Electric Room
You enter the previously pitch dark room with your flashlight on. It feels as if the flashlight could go out any second. You start to get the feeling you aren't the only one in the room. There are walls in this room, so maybe you can find something to help you?

>x walls
You slowly walk to the closest wall with your flashlight. While squinting, you think you can make out switch to turn on the light.

>turn on switch
You turn on the switch, lighting up the room.

* * *

>west
(first opening the oak door)
It seems to be locked.

>north
You can't go that way.

>east
You can't go that way.

* * *

>west
(first opening the oak door)
It seems to be locked.

>west
(first opening the oak door)
It seems to be locked.

>i
You are carrying nothing.

* * *

>x  desk
The desk is a rich, dark brown mahogany with a couple drawers. It is cluttered with a sort of well-organized chaos of files, papers, letters, and god-knows-what-else. There is also your laptop.

>x drawer
Just an ordinary drawer, but I wonder what's inside.

>open drwaer
You can't see any such thing.

>open drawer
You open the drawer, revealing a key.

* * *

>take key
Taken.

>take everyting
You can't see any such thing.

>take everything
There are none at all available!

>w
Darkness
It is pitch dark, and you can't see a thing.

>i
You are carrying:
  a key

>e
My Office
A small cubicle, with just enough space to fit a desk and a relatively comfortable chair.

You can see an oak door here.

>open door with key
You unlock the oak door.

* * *

>take flashlight
Taken.

I beg your pardon?

>i
You are carrying:
  a flashlight
  a key

>e
You can't go that way.

>w
My Office
A small cubicle, with just enough space to fit a desk and a relatively comfortable chair.

You can see an oak door here.

>e
Boss's Office
His chair seems like it is 10 times more comfortable than yours does. But then again, he is your boss.

You can see an oak door here.

>w
My Office
A small cubicle, with just enough space to fit a desk and a relatively comfortable chair.

You can see an oak door here.

* * *

>w
Darkness
It is pitch dark, and you can't see a thing.

>turn on flashlight
It's really not that bright. The batteries are probably almost dead. But it's better than nothing and at least it works in dark rooms.

Electric Room
You enter the previously pitch dark room with your flashlight on. It feels as if the flashlight could go out any second. You start to get the feeling you aren't the only one in the room. There are walls in this place so maybe there's a light switch?

>x walls
You slowly walk to the closest wall with your flashlight. While squinting, you think you can make out switch to turn on the light.

>turn on switch
As you turn the switch on, you can finally see everything in the room.

>switch off switch
You turn off the lights.

It is now pitch dark in here!

>turn on switch
You can't see any such thing.

>x wall
You can't see any such thing.

>w
You can't go that way.

>e
My Office
A small cubicle, with just enough space to fit a desk and a relatively comfortable chair.

You can see an oak door here.

>w
Darkness
It is pitch dark, and you can't see a thing.

>i
You are carrying:
  a flashlight
  a key

>turn on flashlight
That's already on.

>i
You are carrying:
  a flashlight
  a key

* * *

>turn on flashlight
That's already on.

>e
My Office
A small cubicle, with just enough space to fit a desk and a relatively comfortable chair.

You can see an oak door here.

* * *

>w
Darkness
It is pitch dark, and you can't see a thing.

>turn off flashlight
You switch off the flashlight.

>turn on flashlight
It's really not that bright. The batteries are probably almost dead. But it's better than nothing and at least it works in dark rooms.

Electric Room
You enter the previously pitch dark room with your flashlight on. It feels as if the flashlight could go out any second. You start to get the feeling you aren't the only one in the room. There are walls in this place so maybe there's a light switch?

>x wall
You slowly walk to the closest wall with your flashlight. While squinting, you think you can make out switch to turn on the light.

>x walls
You slowly walk to the closest wall with your flashlight. While squinting, you think you can make out switch to turn on the light.

>x wall
You slowly walk to the closest wall with your flashlight. While squinting, you think you can make out switch to turn on the light.

>turn on switch
As you turn the switch on, you can finally see everything in the room.

* * *

>x cubicle
You can't see any such thing.

>x desk
The desk is a rich, dark brown mahogany with a couple drawers. It is cluttered with a sort of well-organized chaos of files, papers, letters, and god-knows-what-else. There is also your laptop.

>x laptop
You check the WiFi bars at the top right. Sadly, there is no WiFi connection where you are right now. I wonder why the WiFi is down...

>take laptop
Taken.

>x chair
It looks pretty comfortable, but you have more important things to do than to sit around.

>x files
You can't see any such thing.

>x papers
You can't see any such thing.

>x letters
You can't see any such thing.

>x drawers
Just an ordinary drawer, but I wonder what's inside.

* * *

>take key
Taken.

>x oak door
You need a key

>e
(first opening the oak door)
It seems to be locked.

>n
Hallway
The long spacious hallway leads to the Elevator. There are a couple pictures posted on the walls.

* * *

>s
My Office
A small cubicle, with just enough space to fit a desk and a relatively comfortable chair.

You can see an oak door here.

>w
Darkness
It is pitch dark, and you can't see a thing.

* * *

>e
My Office
A small cubicle, with just enough space to fit a desk and a relatively comfortable chair.

You can see an oak door here.

>n
Hallway
The long spacious hallway leads to the Elevator. There are a couple pictures posted on the walls.

>x elevator
You can't see any such thing.

>x pictures
Someone enjoys Picaso's paintings, especially the Starry Night.

>take pictures
That's hardly portable.

>x starry night
You can't see any such thing.

>s
My Office
A small cubicle, with just enough space to fit a desk and a relatively comfortable chair.

You can see an oak door here.

>unlock oak door
What do you want to unlock the oak door with?

>key
You unlock the oak door.

>w
Darkness
It is pitch dark, and you can't see a thing.

* * *

>e
My Office
A small cubicle, with just enough space to fit a desk and a relatively comfortable chair.

You can see an oak door here.

>e
(first opening the oak door)

Boss's Office
His chair seems like it is 10 times more comfortable than yours does. But then again, he is your boss.

You can see an oak door and a flashlight here.

>x flashlight
Oh look! It's a working flashlight. At least you don't have to find the batteries.

The flashlight is currently switched off.

>take flashlight
Taken.

>x chair
You can't see any such thing.

>w
My Office
A small cubicle, with just enough space to fit a desk and a relatively comfortable chair.

You can see an oak door here.

* * *

>w
Darkness
It is pitch dark, and you can't see a thing.

>turn on flash light
You can't see any such thing.

>turn on flashlight
It's really not that bright. The batteries are probably almost dead. But it's better than nothing and at least it works in dark rooms.

Electric Room
You enter the previously pitch dark room with your flashlight on. It feels as if the flashlight could go out any second. You start to get the feeling you aren't the only one in the room. There are walls in this place so maybe there's a light switch?

>turn on light switch
You can't see any such thing.

>x light switch
You can't see any such thing.

>x walls
You slowly walk to the closest wall with your flashlight. While squinting, you think you can make out switch to turn on the light.

>turn on light
You can't see any such thing.

>turn on switch
You turn on the switch, lighting up the room.

>l
Electric Room
You enter the previously pitch dark room with your flashlight on. It feels as if the flashlight could go out any second. You start to get the feeling you aren't the only one in the room. There are walls in this place so maybe there's a light switch?

>e
My Office
A small cubicle, with just enough space to fit a desk and a relatively comfortable chair.

You can see an oak door here.

>w
Electric Room
You enter the previously pitch dark room with your flashlight on. It feels as if the flashlight could go out any second. You start to get the feeling you aren't the only one in the room. There are walls in this place so maybe there's a light switch?

>turn on switch
That's already on.

>turn off switch
You turn off the lights.

It is now pitch dark in here!

>turn on switch
You can't see any such thing.

>x walls
You can't see any such thing.

>x walls
You can't see any such thing.

>ew
That's not a verb I recognise.

>w
You can't go that way.

* * *

>w
Darkness
It is pitch dark, and you can't see a thing.

>turn on flashlight
That's already on.

>turn off flashlight
You switch off the flashlight.

* * *

>x desk
The desk is a rich, dark brown mahogany with a couple drawers. It is cluttered with a sort of well-organized chaos of files, papers, letters, and god-knows-what-else. There is also your laptop.

>open drawers
You open the drawer, revealing a key.

>take key
Taken.

* * *

>take flashlight
Taken.

>x chair
A 1956 Eames Lounge chair, one of the most comfortable chairs you have ever seen. But considering you don't even have clearance to be in this room, you should probably go soon.

>w
My Office
A small cubicle, with just enough space to fit a desk and a relatively comfortable chair.

You can see an oak door here.

* * *

>w
Darkness
It is pitch dark, and you can't see a thing.

>turn on flashlight
It's really not that bright. The batteries are probably almost dead. But it's better than nothing and at least it works in dark rooms.

Electric Room
You enter the previously pitch dark room with your flashlight on. But, it feels as if the flashlight could go out any second. Not only this, but you start to get the feeling you aren't the only one in the room. There are walls in this room, so maybe you can find something to help you?

>turn on light
Your previous feelings were right! There is a man looking at you from a distance, across you on the other side of the room. You ask him why he is here and he says he goes by the name Hal.

>x hal
You focus in onto him, searching his body for any signs of a weapon. You catch a glimpse of a pistol hidden in his right hand, Hal, trying to conceal it. He is most definetly a spy, but I doubt you can fight him with only your fists.

>x hal
You focus in onto him, searching his body for any signs of a weapon. You catch a glimpse of a pistol hidden in his right hand, Hal, trying to conceal it. He is most definetly a spy, but I doubt you can fight him with only your fists.

>talk to hal
Isn't it kind of weird to talk to someone who was hiding in a dark room and you just met?

>x hal
You focus in onto him, searching his body for any signs of a weapon. You catch a glimpse of a pistol hidden in his right hand, Hal, trying to conceal it. He is most definetly a spy, but I doubt you can fight him with only your fists.

* * *

>talk to hal
Isn't it kind of weird to talk to someone who was hiding in a dark room and you just met?

>talk to hal
Isn't it kind of weird to talk to someone who was hiding in a dark room and you just met?

* * *

>x hal
You focus in onto him, searching his body for any signs of a weapon. You catch a glimpse of a pistol hidden in his right hand, Hal, trying to conceal it. He is most definetly a spy, but I doubt you can fight him with only your fists.

>attack hal
Before you can even think about killing the spy, he is suddenly right in front of you. You haven't practiced much hand-to-hand combat, and as soon as you realize it, the lights go out.

    *** The End ***

Would you like to RESTART, RESTORE a saved game, QUIT or UNDO the last command?

>restart
You are part of an organization known as the CIA. Your boss has given you a task: You need to send a top secret document that will aid the United States in their quarrel against ISIS. Currently, ISIS is attacking the US and they are growing in numbers. This document has blueprints for a technology that will aid in the fight against the terrorists. But more importantly, you need reliable WiFi to send this document. You don't want it to fall into the wrong hands. Find a reliable WiFi connection so you can send the document.

Reliable WiFi
An Interactive Fiction by kstoffer17
Release 1 / Serial number 170227 / Inform 7 build 6M62 (I6/v6.33 lib 6/12N) SD

My Office
A small cubicle, with just enough space to fit a desk and a relatively comfortable chair.

You can see an oak door here.

>x cubicle
You can't see any such thing.

>x files
You can't see any such thing.

>x files
You can't see any such thing.

* * *

>take laptop
Taken.

>x drawer
Just an ordinary drawer, but I wonder what's inside.

>take key
You can't see any such thing.

>open drawer
You open the drawer, revealing a key.

* * *

>s
You can't go that way.

>w
Darkness
It is pitch dark, and you can't see a thing.

>n
You can't go that way.

* * *

>s
You can't go that way.

>e
My Office
A small cubicle, with just enough space to fit a desk and a relatively comfortable chair.

You can see an oak door here.

>take flashlight
You can't see any such thing.

>w
Darkness
It is pitch dark, and you can't see a thing.

* * *

>s
You can't go that way.

>w
You can't go that way.

>n
You can't go that way.

>e
My Office
A small cubicle, with just enough space to fit a desk and a relatively comfortable chair.

You can see an oak door here.

* * *

>n
You can't go that way.

>n
You can't go that way.

>x wifi
You can't see any such thing.

>s
You can't go that way.

* * *

>w
You can't go that way.

>x wifi
You can't see any such thing.

>take gun
You can't see any such thing.

>s
You can't go that way.

* * *

>w
You can't go that way.

I beg your pardon?

>e
My Office
A small cubicle, with just enough space to fit a desk and a relatively comfortable chair.

You can see an oak door here.

>s
You can't go that way.

>s
You can't go that way.

I beg your pardon?

>e
(first opening the oak door)

Boss's Office
His chair seems like it is 10 times more comfortable than yours does. But then again, he is your boss.

You can see an oak door and a flashlight here.

>s
You can't go that way.

>e
You can't go that way.

* * *

>w
Darkness
It is pitch dark, and you can't see a thing.

>s
You can't go that way.

* * *

>w
Darkness
It is pitch dark, and you can't see a thing.

>w
You can't go that way.

>w
You can't go that way.

>i
You are carrying:
  a key
  a laptop

>w
You can't go that way.

>turn on flashlight
You can't see any such thing.

>use flashlight
That's not a verb I recognise.

>x flashlight
You can't see any such thing.

>i
You are carrying:
  a key
  a laptop

>e
My Office
A small cubicle, with just enough space to fit a desk and a relatively comfortable chair.

You can see an oak door here.

>e
Boss's Office
His chair seems like it is 10 times more comfortable than yours does. But then again, he is your boss.

You can see an oak door and a flashlight here.

>take flashlight
Taken.

>s
You can't go that way.

* * *

>w
Darkness
It is pitch dark, and you can't see a thing.

>turn on flashlight
It's really bright. But at least it works in dark rooms.

Electric Room
As you enter the room and turn on the flashlight, you can see various things around the room.

You can see Hal here.

>x hal
You see nothing special about Hal.

>talk to hal
You focus in onto him, searching his body for any signs of a weapon. You catch a glimpse of a pistol hidden. He is most definetly a spy.

>attack hal
Before you can even think about killing the spy, he is suddenly right in front of you. You haven't practiced much hand-to-hand combat, and as soon as you realize it, the lights go out.

    *** The End ***

Would you like to RESTART, RESTORE a saved game, QUIT or UNDO the last command?

>restart
You are part of an organization known as the CIA. Your boss has given you a task: You need to send a top secret document that will aid the United States in their quarrel against ISIS. Currently, ISIS is attacking the US and they are growing in numbers. This document has blueprints for a technology that will aid in the fight against the terrorists. But more importantly, you need reliable WiFi to send this document. You don't want it to fall into the wrong hands. Find a reliable WiFi connection so you can send the document.

Reliable WiFi
An Interactive Fiction by kstoffer17
Release 1 / Serial number 170224 / Inform 7 build 6M62 (I6/v6.33 lib 6/12N) SD

My Office
A small cubicle, with just enough space to fit a desk and a relatively comfortable chair.

You can see an oak door here.

>x desk
The desk is a rich, dark brown mahogany with a couple drawers. It is cluttered with a sort of well-organized chaos of files, papers, letters, and god-knows-what-else. There is also your laptop.

* * *

>open drawer
You open the drawer, revealing a key.

>take eky
You can't see any such thing.

>take key
Taken.

* * *

>s
My Office
A small cubicle, with just enough space to fit a desk and a relatively comfortable chair.

You can see an oak door here.

>e
(first opening the oak door)

Boss's Office
His chair seems like it is 10 times more comfortable than yours does. But then again, he is your boss.

You can see an oak door and a flashlight here.

* * *

I beg your pardon?

>n
You can't go that way.

* * *

>e
You can't go that way.

>n
You can't go that way.

>w
My Office
A small cubicle, with just enough space to fit a desk and a relatively comfortable chair.

You can see an oak door here.

* * *

>n
Outdoors
The weather could be better, it's a stormy day. The dark clouds cover the sun, and you can sense the rain incoming. You should probably get to some cover.

>s
Elevator
A standard elevator. The elevator door creaks as the it slowly closes. Hopefully this will lead you to the 1st floor.

* * *

>w
Starbucks
The smell of freshly brewed roasted coffee fills the air. There is a relatively long waiting line, but it's worth it. You don't want to be that one person who uses the wifi without purchasing anything.

>x wifi
You open your laptop, accepting the terms and conditions for the free WiFi. Then, you wait, hoping perhaps you will get at least 3 or 4 bars. ....Bummer! The WiFi is 2 bars. While examining the WiFi on your computer, you catch the glimpse of what seems like to be a secret door towards the back of the place, near the bathrooms. You walk to the secret door and open it revealing a gun.

>take gun
You grab the gun and pull the magazine out. 15 rounds of 9mm. You take it with you and fix it to your waist for easy access, while covering it with your CIA weather windbreaker for concealment.

>i
You are carrying:
  a gun
  a flashlight
  a key
  a laptop

>w
You can't go that way.

>e
Outdoors
The weather could be better, it's a stormy day. The dark clouds cover the sun, and you can sense the rain incoming. You should probably get to some cover.

I beg your pardon?

>s
Elevator
A standard elevator. The elevator door creaks as the it slowly closes. Hopefully this will lead you to the 1st floor.

>e
Hallway
The long spacious hallway leads to the Elevator. There are a couple pictures posted on the walls.

>n
You can't go that way.

* * *

>turn on flashlight
It's really bright. But at least it works in dark rooms.

Electric Room
As you enter the room and turn on the flashlight, you can see various things around the room.

You can see Hal here.

>talk to hal
You focus in onto him, searching his body for any signs of a weapon. You catch a glimpse of a pistol hidden. He is most definetly a spy.

>attack hal
You quickly raise the gun to aim and shoot with speed. There is nothing in left in your way to resetting the wifi now in order to send the document. You quickly restart the WiFi in the building! Then you rush back to your desk and open your laptop. You send the top secret document. You have successfully defended your country from future attacks.

    *** The End ***

Would you like to RESTART, RESTORE a saved game, QUIT or UNDO the last command?

* * *

>take key
Taken.

>w
Darkness
It is pitch dark, and you can't see a thing.

* * *

>e
My Office
A small cubicle, with just enough space to fit a desk and a relatively comfortable chair.

You can see an oak door here.

>e
(first opening the oak door)
It seems to be locked.

>open door with key
You unlock the oak door.

* * *

>take flashlight
Taken.

>e
You can't go that way.

* * *

>w
Darkness
It is pitch dark, and you can't see a thing.

>turn on flashlight
It's really not that bright. The batteries are probably almost dead. But it's better than nothing and at least it works in dark rooms.

Electric Room
You enter the previously pitch dark room with your flashlight on. As you look around you can see various things around the room. x  You start to get the feeling you aren't the only one in the room.

>x flashlight
Oh look! It's a working flashlight. At least you don't have to find the batteries.

The flashlight is currently switched on.

>x flashlight
Oh look! It's a working flashlight. At least you don't have to find the batteries.

The flashlight is currently switched on.

>x hal
You see nothing special about Hal.

>x hal
You see nothing special about Hal.

* * *

>attack hal
Before you can even think about killing the spy, he is suddenly right in front of you. You haven't practiced much hand-to-hand combat, and as soon as you realize it, the lights go out.

    *** The End ***

Would you like to RESTART, RESTORE a saved game, QUIT or UNDO the last command?

>restart
You are part of an organization known as the CIA. Your boss has given you a task: You need to send a top secret document that will aid the United States in their quarrel against ISIS. Currently, ISIS is attacking the US and they are growing in numbers. This document has blueprints for a technology that will aid in the fight against the terrorists. But more importantly, you need reliable WiFi to send this document. You don't want it to fall into the wrong hands. Find a reliable WiFi connection so you can send the document.

Reliable WiFi
An Interactive Fiction by kstoffer17
Release 1 / Serial number 170226 / Inform 7 build 6M62 (I6/v6.33 lib 6/12N) SD

My Office
A small cubicle, with just enough space to fit a desk and a relatively comfortable chair.

You can see an oak door here.

>x desk
The desk is a rich, dark brown mahogany with a couple drawers. It is cluttered with a sort of well-organized chaos of files, papers, letters, and god-knows-what-else. There is also your laptop.

>x drawers
Just an ordinary drawer, but I wonder what's inside.

* * *

>take flashlight
Taken.

>m
That's not a verb I recognise.

>w
My Office
A small cubicle, with just enough space to fit a desk and a relatively comfortable chair.

You can see an oak door here.

* * *

>x wifi
You open your laptop, accepting the terms and conditions for the free WiFi. Then, you wait, hoping perhaps you will get at least 3 or 4 bars. ....Bummer! The WiFi is 2 bars. While examining the WiFi on your computer, you catch the glimpse of what seems like to be a secret door towards the back of the place, near the bathrooms. You walk to the secret door and open it revealing a gun.

>x gun
A Beretta 92 handgun.

>take gun
You grab the gun and pull the magazine out. 15 rounds of 9mm. You take it with you and fix it to your waist for easy access, while covering it with your CIA weather windbreaker for concealment.

>e
Outdoors
The weather could be better, it's a stormy day. The dark clouds cover the sun, and you can sense the rain incoming. You should probably get to some cover.

>w
Starbucks
The smell of freshly brewed roasted coffee fills the air. There is a relatively long waiting line, but it's worth it. You don't want to be that one person who uses the wifi without purchasing anything.

>e
Outdoors
The weather could be better, it's a stormy day. The dark clouds cover the sun, and you can sense the rain incoming. You should probably get to some cover.

>n
McDonalds
As you enter the restaurant, the smell of grease fills the air. A whole new world of diabetes and clogged heart arteries is here. Welcome to McDonald's an employee says. There is also free Wifi here.

>e
You can't go that way.

>s
Outdoors
The weather could be better, it's a stormy day. The dark clouds cover the sun, and you can sense the rain incoming. You should probably get to some cover.

* * *

>s
My Office
A small cubicle, with just enough space to fit a desk and a relatively comfortable chair.

You can see an oak door here.

>x chair
It looks pretty comfortable, but you have more important things to do than to just sit.

* * *

>x drawers
Just an ordinary drawer, but I wonder what's inside.

>open drawers
You open the drawer, revealing a key.

* * *

>take key
Taken.

>x door
You need a key

>open door
It seems to be locked.

>open door with key
You unlock the oak door.

>n
Hallway
The long spacious hallway leads to the Elevator. There are a couple pictures posted on the walls.

* * *

>e
You can't go that way.

>s
My Office
A small cubicle, with just enough space to fit a desk and a relatively comfortable chair.

You can see an oak door here.

>s
You can't go that way.

* * *

>w
You can't go that way.

>n
Hallway
The long spacious hallway leads to the Elevator. There are a couple pictures posted on the walls.

* * *

>w
My Office
A small cubicle, with just enough space to fit a desk and a relatively comfortable chair.

You can see an oak door here.

>d
You can't go that way.

>n
Hallway
The long spacious hallway leads to the Elevator. There are a couple pictures posted on the walls.

* * *

>e
You can't go that way.

>d
You can't go that way.

>c
That's not a verb I recognise.

>s
My Office
A small cubicle, with just enough space to fit a desk and a relatively comfortable chair.

You can see an oak door here.

* * *

>x wifi
You can't see any such thing.

>x WiFi
You can't see any such thing.

>take wifi
You can't see any such thing.

>x Wifi
You can't see any such thing.

* * *

>x desk
The desk is a rich, dark brown mahogany with a couple drawers. It is cluttered with a sort of well-organized chaos of files, papers, letters, and god-knows-what-else. There is also your laptop.

>x desk
You can't see any such thing.

>x drawer
You can't see any such thing.

>x desk
You can't see any such thing.

* * *

>open drawers
You open the drawer, revealing a key.

>take ey
You can't see any such thing.

>key
That's not a verb I recognise.

>take key
Taken.

>east
(first opening the oak door)
It seems to be locked.

>open door with key
You unlock the oak door.

>east
(first opening the oak door)

Boss's Office
His chair seems like it is 10 times more comfortable than yours does. But then again, he is your boss.

You can see an oak door and a flashlight here.

>take flashlight
Taken.

>i
You are carrying:
  a flashlight
  a key

>west
My Office
A small cubicle, with just enough space to fit a desk and a relatively comfortable chair.

You can see an oak door here.

>west
Darkness
It is pitch dark, and you can't see a thing.

I beg your pardon?

* * *

>i
You are carrying:
  a flashlight
  a key

>use flashlight
That's not a verb I recognise.

>turn on flashlight
It's really bright. But at least it works in dark rooms.

Electric Room

>x flashlight
Oh look! It's a working flashlight. At least you don't have to find the batteries

The flashlight is currently switched on.

>x flashlight
Oh look! It's a working flashlight. At least you don't have to find the batteries

The flashlight is currently switched on.

>x electric room
You can't see any such thing.

* * *

>x drawers
Just an ordinary drawer, but I wonder what's inside.

>x drawers
It's a drawer.

* * *

>open drawer
You open the drawer, revealing a key.

>open drawers
That's already open.

>take key
Taken.

>x drawer
It's a drawer.

>east
(first opening the oak door)
It seems to be locked.

>open oak door
It seems to be locked.

>use key
That's not a verb I recognise.

>use key on oak door
That's not a verb I recognise.

>open oak door with key
You unlock the oak door.

>east
(first opening the oak door)

Boss's Office
His chair seems like it is 10 times more comfortable than yours does. But then again, he is your boss.

You can see an oak door here.

* * *

>x drawers
Just an ordinary drawer, but I wonder what's inside.

>x papers
You can't see any such thing.

>x drawer
It's a drawer.

>i
You are carrying nothing.

>take key
You can't see any such thing.

* * *

>x dsek
You can't see any such thing.

>x desk
You can't see any such thing.

* * *

>x files
You have more important matters than to look through the hundreds of papers, files, and letters on your desk.

>x paper
You have more important matters than to look through the hundreds of papers, files, and letters on your desk.

>x papers
You have more important matters than to look through the hundreds of papers, files, and letters on your desk.

>x cubicle
Just an ordinary cubicle, like the hundreds of them in this building.

>e
(first opening the oak door)
It seems to be locked.

>w
Darkness
It is pitch dark, and you can't see a thing.

>x desk
You can't see any such thing.

>ew
That's not a verb I recognise.

>e
My Office
A small cubicle, with just enough space to fit a desk and a relatively comfortable chair.

You can see an oak door here.

>open drawer
You open the drawer, revealing a key.

* * *

>take key
Taken.

>x
(the key)
Just an ordinary key.

>open door with key
You unlock the oak door.

* * *

>turn on light
Your previous feelings were right! There is a man looking at you from a distance, across you on the other side of the room. You ask him why he is here and he says he goes by the name Hal.

>talk to hal'
You can't see any such thing.

>talk to hal
Isn't it kind of weird to talk to someone who was hiding in a dark room and you just met?

>x hal
You focus in onto him, searching his body for any signs of a weapon. You catch a glimpse of a pistol hidden at his side, trying to conceal it. He is most definetly a spy, but I doubt you can fight him with only your fists.

* * *

>x me
Without a mirror you don't really know what you look like,  but the navy blue suit you are wearing looks snazzy and can be considered as "buisness casual".

>x me
Without a mirror you don't really know what you look like,  but the navy blue suit you are wearing looks snazzy and can be considered as "buisness casual".

>x desk
You can't see any such thing.

>x desk
You can't see any such thing.

>north
Hallway
The long spacious hallway leads to the Elevator. There are a couple pictures posted on the walls.

>west
Elevator

>east
Hallway
The long spacious hallway leads to the Elevator. There are a couple pictures posted on the walls.

>east
You can't go that way.

>south
My Office
A small cubicle, with just enough space to fit a desk and a relatively comfortable chair.

You can see an oak door here.

>x desk
You can't see any such thing.